Test 1
__________________________________________________
___________________B______________________________
___________________B______________________________
________G__________B_________________P____________
___________________B______________________________
___________________B______________________________
___________________B______________________________
__________________________________________________
__________________________________________________
__________________________________________________

Test 2
___________________B______________________________
___________________B______________B_______________
___________________B______________B_______________
________P__________B__________B___B__G____________
___________________B__________B___B_______________
___________________B__________B___B_______________
___________________BBBBBBBBBBBB___BB_BBBBBBBBBBBBB
__________________________________________________
__________________________________________________
__________________________________________________

Test 3
___________________B______________BBBBBBBBBBBBB___
___________________B______________B_______________
___________________B______________B__BBBBBBB______
___________________B______________B__B____________
___________________BBBBBBBBBBBBBBBB__B____________
_______________P_____________________B______G_____
___________________BBBBBBBBBBBBBBBBBBB____________
__________________________________________________
___________________B______________________________
___________________B______________________________

Test 4
___________________B______________BBBBBBBBBBBBB___
___________________B______________B_______________
___________________B______________B__BBBBBBB______
___________________B______________B__B____________
___________________BBBBBBBBBBBBBBBB__B____________
_______________P___B_________________B______G_____
___________________BBBBBBBBBBBBBBBBBBB____________
___________________B______________________________
___________________B______________________________
___________________B______________________________

BFS
36
56

Astar
32
158

Dijkstra
32
1094

